L=4
N=16
K=5
LEVEL 1
R R E G B B T1 B T1 T2 G G G B  T1 T2
R R E G B B E  B T1 T2 G G E B  T1 T2
R R E E E E E  E T3 T2 G G G B  T1 T2
R R E G B B T1 B T1 T2 G G G W  T1 T2
R R E E B B E  B T1 T2 G G E B  T1 T2
R R G E E E E  E T3 T2 G G G B  T1 T2
R R E G B B T1 E T1 T2 G G G B  T1 T2
R R E G B B E  E T1 T2 G G E B  T1 T2
R R G E E E E  E T3 T2 G G E B  T1 T2
R R E G B B T1 E T1 T2 G G E B  T1 T2
R R E G B B E  E E E  E E E B  E  E
R R G E E E E  E T3 T2 G E G B  T1 T2
R R G E E E E  E T3 T2 G E E B  T1 T2
R R E G B B T1 B T1 T2 G G E W  T1 T2
R R E G B B E  E E  E  E E E B  T1 T2
R R G E E E E  E T3 T2 G G G B  T1 T2
LEVEL 2
T1 E T1 T1 T1 T1 T1 T1 T1 T2 T1 T1 T1 T1 T1 T2
R E T1 R B B E  B T1 T2 G G E B T1 T2
R E T2 E E E E  E T3 T2 G G G B T1 T2
R E E G W B T1 B T1 T2 G G G B  T1 T2
R R E G B B E  B T1 T2 G G E B  T1 T2
R R G E E E E  E T3 T2 G G G B  T1 T2
R R E G B B T1 B T1 T2 G G G B  T1 T2
R R E G B B T1 B T1 T2 G G G B  T1 T2
R R E G B B E  B T1 T2 G G E B  W T2
R R G E E E E  E T3 T2 E G G B  T1 T2
R R E G B B T1 B T1 T2 E G G B  T1 T2
R R E G B B T1 B T1 T2 E G G B  T1 T2
R R E G B B E  B T1 T2 E E E B  T1 T2
R R G E E E E  E T3 T2 G G G B  T1 T2
R R E G B B T1 B T1 T2 G G G B  T1 T2
R R G E E E E  E T3 T2 G G G B  T1 T2
LEVEL 3
R R E G B B T1 B T1 T2 G G G B  T1 T2
R R E G B B E  B T1 T2 G G E B  T1 T2
R R G E E E E  E T3 T2 G G G B  T1 T2
R R E W B B T1 B T1 T2 G G G B  T1 T2
R R E G B B E  B T1 T2 G G E B  T1 T2
R R G E E E E  E T3 T2 G G G B  T1 T2
R R E G B B T1 B T1 T2 G G G B  T1 T2
R R E G B B E  B E  E  E G E B  T1 T2
R R G E E E E  E T3 T2 G G E B  T1 T2
R R E G B B T1 B T1 T2 G G E B  T1 T2
R R E G B B E  B T1 E  E E E B  W T2
R R G E E E E  E T3 T2 G E G B  T1 T2
R R G E E E E  E T3 T2 G E E B  T1 T2
R R E G B B T1 B T1 T2 G G E B  T1 T2
R R E G B B E  E E  E  E E E B  T1 T2
R R G E E E E  E T3 T2 G G G B  T1 T2
LEVEL 4
R W E G B B T1 B T1 T2 G G G B  T1 T2
R R E G B B E  B T1 T2 G G E B  T1 T2
R R G E E E E  E T3 T2 G G G B  T1 T2
R R E G B B T1 B T1 T2 G G G B  T1 T2
R R E G B B E  B T1 T2 G G E B  T1 T2
R R G E E E E  E T3 T2 G G G B  T1 T2
R R E G B B T1 B T1 T2 G G G B  T1 T2
R R E G B B E  B T1 T2 G G E B  T1 T2
R R G E E E E  E T3 T2 G G E B  T1 T2
R R E G B B T1 B T1 T2 G G E B  T1 T2
R R E G B B E  B T1 E  E E E B  T1 T2
R R G E E E E  E T3 T2 G E G B  T1 T2
R R G E E E E  E T3 T2 G E E B  T1 T2
R R E G B B T1 B T1 T2 G G E B  T1 T2
R R E G B B E  E E  E  E E E B  T1 T2
R R G E E E E  E T3 T2 G G G W  T1 T2
END OF MAZE
